step,zdrowi,odporni,chorzy - faza 1,chorzy - faza 2,cała populacja,chorzy ogółem
0,385,95,48,55,488,103
1,390,45,77,48,515,125
2,373,35,89,76,538,165
3,341,57,98,85,524,183
4,293,61,86,90,469,176
5,246,63,74,76,396,150
6,191,50,55,61,307,116
7,148,40,43,45,236,88
8,131,35,36,39,206,75
9,109,28,29,31,169,60
10,91,23,19,25,135,44
11,80,20,13,16,109,29
12,69,13,10,11,90,21
13,55,9,7,9,71,16
14,45,7,3,6,54,9
15,37,5,1,2,40,3
16,27,2,0,1,28,1
17,19,1,0,0,19,0
